111111111
101111111
100010011
101110101
101000101
100010001
101110111
101111111
101111111
101111111
111111111