111111111111111
111111011111111
100000000000001
101111111111101
101000000000101
101111111110101
111000000000101
101011111111101
101000000000101
101111111010101
101000000010101
101011111110101
101000000010101
101111111010101
100000000010101
111111111010101
100000000010001
101111111111111
111111111111111
